    
R  1350 600
    NO ./textures/wall-4.xpm 

SO ./textures/wall-1.xpm
WE ./textures/wall-3.xpm
EA ./textures/wall-2.xpm
S ./textures/tree.xpm
F    86 , 130, 3
C   107  , 212  ,225    

1111111111111
1000000000001
1000000000001
1000000000001
100000000W001
1000000000001
1000000000001
1000000000001
1000000000001
1000000000001
1000000000001
1000000000001
1000000000001
1000000000001
1000000000001
1000000000001
1000000000001
1000000000001
1000000000001
1000000000001
1000000000001
1111111111111
