    
R 5000   5000
    NO ./textures/colorstone.xpm 
SO ./textures/brick.xpm
WE ./textures/moss.xpm
EA ./textures/wood.xpm
S ./textures/eagle.xpm
F    44 ,  12  ,  8
C     212, 172  ,13    


 11111111111
100022000121
100000000001  
100000000001
1000000000001
1000000000001
1000000000001
1000000000001
100S000000001
1000000200001
1100000000001
100000000001
100000020001
100000000001
100000000001
100000000001
100000000001
100000000001
1000000000001
100000000001
100000001101
100000000001
11111111111
