    
R 5000   5000
    NO ./textures/colorstone.xpm 
SO ./textures/brick.xpm
WE ./textures/moss.xpm
EA ./textures/wood.xpm
S ./textures/tree.xpm
F    214 ,  250  ,  0
C     250, 20  ,0    


 11111111111
100022000121
100000000001  
100000000001
1000000000001
1000000000001
1000000000001
1000000000001
1000000000N01
1000000200001
1100000000001
1000000000001
100000020001
100000000001
100000000001
100000000001
100000000001
100000000001
1000000000001
100000000001
100000001101
100000000001
11111111111
