    
R 1000   500
    NO ./textures/colorstone.xpm 
SO ./textures/brick.xpm
WE ./textures/moss.xpm
EA ./textures/wood.xpm
S ./textures/tree.xpm
F    214 ,  250  ,  0
C     250, 20  ,0    


 11111111111
100022000121
10000S000001  
100000020001
1000000200001
100222000001
1000000110001
1000020000001
1000002001101
1000000200001
1100002000001
100222000001
100000020001
100000000001
100000001101
100000000001
100000000001
100002000001
1000000210001
100000000001
100000001101
100000000001
11111111111
