    
R  1350 600
    NO ./textures/wall-4.xpm 

SO ./textures/wall-1.xpm
WE ./textures/wall-3.xpm
EA ./textures/wall-2.xpm
S ./textures/tree.xpm
F    86 , 130, 3
C   107  , 212  ,225    

111111111111111111111111111
100000000000000000000000001
100000000000000000000000001
100000000000000000000000001
100000000000000000000000001
100000000000000000000000001
100000000000000000000000001
100000000000000000000000001
100000000000000000000000001
100000000000000000000000001
100000000000000000000000001
 10111111111000001111111111
100022000121000001
100000000001000001
100000000001100001
100001110000011111
10000000000001
11000200W00001
11000000000001
11000021100011
11000000000001
11001002200001
10000100000001
10000200000001
10000000000001
11111000000001
1000000002001
1002000000001
1000000000001
1101010101011
101010101011
100000001101
100000000001
11111111111
