    R 550   750
    NO ./textures/colorstone.xpm 
SO ./textures/brick.xpm
WE ./textures/moss.xpm
EA ./textures/wood.xpm
S ./textures/tree.xpm
F   214 ,   250  ,  0  
C     250, 20  ,0    


111111111111
100000000001
100000000001
1000000N0001
100000000001
100000000001
111111111111
