    R 1000   200
    NO ./textures/colorstone.xpm 
SO ./textures/brick.xpm
WE ./textures/moss.xpm
EA ./textures/wood.xpm
S ./textures/tree.xpm
F    b214 ,  250  ,  0
C     250, 20  ,0    


 11111111111
100020000121
100000000001
1000000N0001
100000000001
100000000001
100000000001
100000000001
100000000001
100002000001
100000000001
100000000001
100000000001
100000000001
100200200001
100000000001
100000000001
100000200001
100000000001
100002000001
100000000001
100000000001
100000000001
100000000001
111111111111
