R 1920 1080

    NO ./textures/colorstone.xpm 
SO ./textures/brick.xpm
WE ./textures/moss.xpm
EA ./textures/wood.xpm
S ./textures/eagle.xpm
F   ,   250  ,  0  
C     250, 0 ,0 
11111111111111111
10000000000000001
10000000000000001
12000200020020001
10000000000000001
100000200202000001
12002002220000001
10000002000000001
10000002000020001
10000000000000001
10000020020000001
10002000000200001
10000000000000001
10000000000000001
10000000000000001
10000000000000001
11111111111111111
